15x15
~~^^G^^~~~~~~~~
~~~^^^^~~~~~~^^
~~~~~~~~~~~^^^^
~~~~~~~~^^^^^^^
^~^^^^^^^^^^^^^
^~^^^^^^^^^^^^S
^~~^^^^^^^----^
^~^~^^^^^-^^^^^
^~^^~^^^^^----^
^~^^^~^^^^^^^^-
^~^^^^~^^^^^--^
^~^^^^^~^^^-^^^
^^~^^^^^~^^^--0
^^~^^^^^^~^^###
^^^~^^^^^^~~*0^