20x20
~~^^G^^~~~~~~~~~~~~~
~~~^^^^~~~~~~~~~~~~~
~~~~~~~~~~~~~~~~~~~~
~~~~~~~~~~~~~~~~~~~~
~~~~^^^^^^^^^^^^^^^^
^^^^^^^^^^^^^^^^^^^S
^~^^^^^^^^^^--------
^~^^^^^-----^^^^^^^^
-------^^^^^-^^^^^^^
^~^^^^^^^^^^^------^
^~~^^^^^^^^^^^^^^^^-
^~^~^^^^^^^--------^
^^~^~^^^^^^-^^^^^^^^
^^~^^~^^^^^^^------^
^^^~^^^~^^^^^^^^^^^-
^^^~^^^^~^^^^^^----^
^^^^~^^^^~~^^^-^^^^^
^^^^~^^^^^^^~^^---^^
^^^^^~^^^^^^^~^##-##
^^^^~^^^^^^^^~0#--*0