12x11
~~~G~~~~~~^
~~~~~~~~~^^
^~^^^^^^^^S
1~1-------^
^~##^^^^^^^
^~~##^^^^^^
^~^~##^^^^^
^~^^~##^^^^
^~^^^~##^^^
^^~^^^~##0^
^^~^^^^~###
^^^~^^^~~*0