10x12
~-----~---~~
S^^^^^-^^^-*
~~~~~~~~~~~~
~^^^^^^^^-^~
~^^~~~~^^-^~
^^^^~~^^^-^~
~^^^~^^^^-^~
~^^~^^^^-^~~
~^^~^^^-^~~~
~^^~^^^G~~~~