10x9
####----#
S12--##-#
-###-##-#
---#--*2-
~~~~~-#--
G~^^^----
^#^^^----
^#^^^----
^#^^^----
^^1-----*