50x50
S-------------------------------------------------
--------------------------------------------------
--------------------------------------------------
--------------------------------------------------
--------------------------------------------------
----------#----------------------------#----------
----------#----------------------------#----------
----------#----------------------------#----------
----------#---------^^^^^^^^-----------#----------
----------#---------^^^^^^^^-----------#----------
----------#---------^^^^^^^^-----------#----------
----------#---------^^^^^^^^-----------#----------
----------#---------^^^^^^^^-----------#----------
----------#---------^^^^^^^^-----------#----------
----------#----------------------------#----------
----------#----------------------------#----------
----------#----------------------------#----------
--------------------------------------------------
--------------------------------------------------
--------------------------------------------------
--------------------------------------------------
--------------------------------------------------
----------------------0---------------------------
--------------------------------------------------
--------------------------------------------------
--------------------------------------------------
----------------------0---------------------------
--------------------------------------------------
--------------------------------------------------
--------------------------------------------------
--------------------------------------------------
----------#----------------------------#----------
----------#----------------------------#----------
----------#----------------------------#----------
----------#---------~~~~~~~~-----------#----------
----------#---------~~~~~~~~-----------#----------
----------#---------~~~~~~~~-----------#----------
----------#---------~~~~~~~~-----------#----------
----------#---------~~~~~~~~-----------#----------
----------#---------~~~~~~~~-----------#----------
----------#----------------------------#----------
----------#----------------------------#----------
----------#----------------------------#----------
--------------------------------------------------
--------------------------------------------------
--------------------------------------------------
--------------------------------------------------
-------------------------------------------------G
--------------------------------------------------
--------------------------------------------------