10x9
#########
S-1--####
-########
--------*
~~^^^---2
G~^^^----
^#^^^----
1#^^^---2
-#^^^----
--------*