20x20
S------*#-#--------#
--------#-----0----#
--------#-#--------#
####-####-#-####-###
#0~-----#-#-2------#
#~~-----#-#--------#
#-------#-#--------#
####-####-#####-####
#-------#-#--------#
#-------#-#--------#
#-------#-#--------#
#######-#-##-#######
#-------#-#--------#
#-------#-#--------#
#-------#-#--------#
####-####-#####-####
#2^-----#-#-1------#
#^^-----#-#--------#
#-1-----#-#-------G#
#######---##########