20x20
S------------------#
^^^^^^^^^^^^^^^^^^-#
-------------------#
-~~~~~~~~~~~~~~~~~-#
-~~~~~~~~~~~~~~~~~-#
-~~~~~~~~~~~~~~~~~-#
-~~~~~~~~~~~~~~~~~-#
-~~~~~~~~~~~~~~~~~-#
-~~~~~~~~~~~~~~~~~-#
-~~~~~~~G~~~~~~~~~-#
-~~~~~~~~~~~~~~~~~-#
-~~~~~~~~~~~~~~~~~-#
-~~~~~~~~~~~~~~~~~-#
-~~~~~~~~~~~~~~~~~-#
-------------------#
-^^^^^^^^^^^^^^^^^-#
-^-----------------#
-^-###############-#
-^----------------*#
-###################