11x15
S-------------#
^^^^^^^^^^^^^-#
--------------#
-~~~~~~~~~~~~-#
-~~~~G~~~~~~~-#
-~~~~~~~~~~~~-#
--------------#
-^^^^^^^^^^^^-#
-^------------#
-^-##########-#
-^-----------*#