20x20
####################
S--#--#--#--#--#--0#
##-#-##-##-##-##-###
##-#-##-##-##-##-###
0--#--#--#--#--#--1#
####-##-##-##-##-###
####-##-##-##-##-###
1--#--#--#--#--#--2#
##-####-##-##-##-###
##-####-##-##-##-###
2--#--#--#--#--#--3#
####-####-##-##-##-#
####-####-##-##-##-#
3--#--#--#--#--#--4#
##-#######-##-##-###
##-#######-##-##-###
4--#--#--#--#--#--5#
####-#######-##-##-#
####-#######-##-##-#
5--#--#--#--#--#--G#