12x16
S--#-----#-----#
##-#-###-#-###-#
##-0-###-0-###-#
##-#-###-#-###-#
##-#####-#-###-#
##-------#-----#
##############-#
#--------------#
#-##############
#-----#--------#
#####-#-######-#
#####-G-######-#