13x16
S--#--#--#--#--0
##-#-##-##-##-##
0--#--#--#--#--1
####-##-##-##-##
1--#--#--#--#--2
##-#-##-##-##-##
2--#--#--#--#--4
3###-#-##-#####-
---#--#--#--#--3
##-####-##-##-##
4--#--#--#--#--#
-##-####-##-##-#
5--#--#--#--#5-G