20x20
####################
S--#-------#-------#
##-#-#####-#-#####-#
##-#-#####-#-#####-#
##-0-#####-0-#####-#
##-#-#####-#-#####-#
##-#-#####-#-#####-#
##-#######-#-#####-#
##---------#-------#
##################-#
#------------------#
#-##################
#-------#----------#
#######-#-########-#
#######-#-########-#
#######-G-########-#
##################-#
##################-#
##################-#
####################